MODE 0
SIZE 8/8
LIMIT 0/12
COLOR LIMIT 5
STARS 7300/9200/11000
GETSTARS 2
00 18 00 18 00 18 00 18
18 10 10 10 10 10 10 00
00 10 10 10 10 10 10 18
18 15 10 15 18 15 10 00
00 10 15 18 15 10 15 18
18 10 10 10 10 10 10 00
00 10 10 10 10 10 10 18
18 00 18 00 18 00 18 00