MODE 1
SIZE 8/7
LIMIT 0/20
COLOR LIMIT 5
STARS 7600/11600/15000
COLLECT ITEMS 0/1/
COLLECT COUNT 3/3/ 
10 10 10 10 10 10 10 10
10 10 10 10 10 10 10 10
18 18 18 18 18 18 18 18
10 10 10 10 10 10 10 10
10 10 10 10 10 10 10 10
15 15 15 15 15 15 15 15
15 15 15 15 15 15 15 15