MODE 0
SIZE 8/8
LIMIT 0/20
COLOR LIMIT 5
STARS 6800/9900/14000
GETSTARS 3
00 10 10 10 10 10 10 18
10 00 10 10 10 10 18 10
10 10 00 10 10 18 10 10
10 10 10 00 18 10 10 10
10 10 10 18 00 10 10 10
10 10 18 10 10 00 10 10
10 18 10 10 10 10 00 10
18 10 10 10 10 10 10 00
